10
07 07 17 07 00 04 00 07 07 07
07 27 00 07 07 02 01 07 17 07
07 00 00 07 01 03 02 07 07 07
07 07 37 07 01 02 01 07 07 07
07 07 07 07 00 05 00 07 07 47
