10
07 07 07 07 07 07 07 07 07 07 
07 07 07 07 07 07 07 07 07 07 
07 07 07 37 07 07 07 07 07 07 
07 07 07 07 07 07 07 07 07 07 
07 07 07 07 07 07 27 07 07 07 
07 07 07 07 07 07 07 07 07 07 
07 47 07 07 07 07 07 07 07 07 
07 07 07 07 07 07 07 07 07 07 
07 07 07 07 07 17 00 07 07 07 
07 07 07 07 07 07 04 07 07 07 
07 07 07 27 07 07 01 01 07 07 
07 07 07 07 07 07 01 01 07 07 
07 07 07 07 07 07 01 05 00 07 

