10
07 07 07 07 00 00 04 00 07 27
07 07 02 01 01 01 02 01 07 07
17 07 03 00 03 02 01 07 07 07
07 07 02 00 03 02 01 07 07 07
07 47 01 01 01 02 01 07 07 47
07 07 07 07 00 05 00 00 07 07
