10
07 07 07 07 07 00 04 00 07 07
07 07 02 01 01 01 02 01 07 07
07 07 03 00 03 02 01 07 07 07
07 07 02 00 03 02 01 07 07 07
07 07 01 01 01 02 01 07 07 07
07 07 07 07 00 05 00 07 07 07
