10
07 07 07 00 04 01 01 01 07 07
07 37 07 01 01 01 00 01 07 47
07 07 07 01 00 02 02 02 01 07
07 07 47 01 01 02 01 00 01 07
07 07 07 07 00 01 02 02 01 07
17 07 07 07 01 01 00 01 00 07
07 07 07 00 05 01 01 01 27 07