10
07 07 07 00 00 04 00 07 07 07
07 37 07 03 03 01 01 17 07 07
07 07 07 01 01 01 01 07 67 07
07 07 17 02 01 01 01 07 07 07
07 07 07 01 02 02 01 57 07 07
27 07 07 00 05 00 00 07 07 07