          10
04 01 01 02 02 02 01 01 02 07
01 00 01 01 01 01 00 01 02 07
07 07 02 01 01 01 01 00 01 07
07 01 01 07 07 07 01 02 02 07
07 01 07 07 07 07 07 00 01 00
07 01 01 03 03 02 02 03 05 00