10
07 07 01 01 04 01 01 47 07 07
07 07 01 00 03 00 01 07 07 07
07 17 01 03 06 03 01 07 27 07
07 07 01 00 03 00 01 07 07 07
27 07 02 01 02 01 02 07 07 37
07 07 02 01 05 01 02 07 07 07