10
07 07 00 04 00 07 07 07 07 07
07 07 07 06 02 01 03 06 03 17
07 37 17 03 00 07 07 01 02 07
07 07 06 02 07 02 02 01 47 07
07 17 03 07 07 01 01 07 07 07
27 07 01 07 00 00 01 07 07 57
07 07 04 00 00 05 03 07 07 07